.......#..
...s...#..
..........
##..ooo...
..........
....##...#
..........
....#.....
....#..e..
..........