o....#...#
......#.o.
eo#o......
#..o.o#...
.#.#...#..
.o....o...
#.....o...
..........
.#.o.....s
#...#.o.o.