#s...#...##.......o.
..#............o....
.....o#oo#.#oo#.####
...........oo.o.#...
...#.oo..#.#.#....#.
......o.o..#o..#..o.
.....#....#.....#..o
.##......#.....#....
..#o...#......##oo..
.......#...#.o#.o##.
..#.......o.##..#...
....#o.#..o.#.#..##.
.#.#....o...oo......
..#.....#...#..##.o#
#.#....#.....o#..o#.
.o#...o.o..o.#......
o###..##...#.o.....#
o..#......#o##....#.
..o#....###o#.......
...##.#...#.##..o..e