..........
..........
...#####.e
.......#..
.......#..
.......#..
.......#..
s.######..
..........
..........