s#.....#..
.#.###.##.
.......#..
##.###.##.
.#.....#..
.#.###...#
......##..
###.#..##.
....#.....
.##...###e