e......#....................#...#...#...#...#...##
####.#.#.#######.########.#.#.#...#.#.#...#...#...
.....#.#.#.....#.#........#.#######.#.#####.#.###.
.###.#.....###.#.#.######.#.....................#.
.#...#.###.....#.#.#......#.#######.######.####.#.
.#.#.#.....###.....#.####.#.#.................#.#.
.#.#...###.#.#.###.#..........###############.#.#.
.#.#.##....#.#.....#.###.####.................#.#.
.#.#....##.#...#######...#....########.######.....
.#...####..###.#.......#.#....................#.##
.#.#....#.#.....######.#...#####.########.###.#...
.....##.#...###........#.#....................#.#.
##.#....#.############.#.#.#.#######.########...#.
...#.##.#....#...##....#.#.#.......#..........#.#.
.#.#......##...#....##...#.#.#####.#.###.###..#.#.
.#...#########.####....#...#.#.....#.#.....#......
.#..................##...#...#.###.#.#.###.#.#.###
.#.######.############.#####.#....................
.#.........................#...############.#####.
...###########.###.#######.###....................
.#.................#.........#.#####.#############
.#########.#######...#.#####.#....................
.#.........#.......#.#.#.....#.######.######.####.
...######..#.####.##.#.#.###.#......#.#...........
.#.........#.#.......#.#.#.#.#.###.##.#.########..
.#########.#.#.#.##..#...#.#.....#..#.............
.#.........#.#.##.#####..#.#.###.##.#.######.#####
.###....#....#........................#.#....#.#..
..........##.##############.####.#.##.#.##.#.#.##.
.########..#...............................#.#....
.......#.#.#.######.##########.###########.#.#.##.
.#####.....#.................#.............#.#....
.#...#.###...#########.#####.#.###########.#...##.
...#.#.....#...........#.....#...............#....
##.#...###############.#.###.#.#######.#####...#.#
...#.#.................#.....................#.#.#
.#...#.##.#.####.#.###.#.###.#.#############.#.#.#
.#.#.#.#..#....#.#.##..#..##.#...............#.#.#
.#.#...##.#.##...#....###....##########.#.######.#
.#.##.##..#..#.#.#.##..#..##............#........#
.......#...............#.#.#.####.#####.#.########
#########.############..................#.........
.......................###.#####.######.#.#######.
.###.######.#.########.#..........................
............#.#......#.#.###.########.....########
.######.#.#.#...####.#.#...#....#...#.#.#.#.......
......#.#.#.#.#.#.#......#...#....#...#.#.#.#####.
.####.#...#.#.#.#...#.#################.#.#....s#.
...##.###.#.#.#.#####.#.................#########.
.#............#.......#.###############...........